5 6
WWWWWW
WS   W
WWWW W
WWWE W
WWWWWW
