6 6
XXXXXX
XS   X
XXXX X
XXXE X
XXXX X
XXXXXX
