5 6
XXXXXX
XS   X
XXXX X
XXXE X
XXXXXX
