6 6
WWWWWW
WS   W
WWWW W
WWWE W
WWWW W
WWWWWW
