5 6
XXXXXX
XS   X
XXXX X
XXXXEX
XXXXXX
