5 6
WWWWWW
WS   W
WWWW W
WWWWEW
WWWWWW
