11 11
WWWWWWWWWWW
W      EWSW
W WWW W W W
W W   W W W
W W WWW W W
W     W W W
W WWWWW W W
W       W W
W WWWWWWW W
W         W
WWWWWWWWWWW
